1100000000011111
1000000100000111
1000000000000111
1000000000000111
1000000001000111
1000000000000111
1000000000000111
1000000000011111
1000000000011111
1111111111111111
1111111111111111
1111111111111111