0000000000000000
0000000000000000
0000000000000000
0000000000000000
0000000000000000
0000000022222222
0000000020000000
0000000020000000
0000000020000000
0000000020000000
0000000020000000
0000000020000000