1111100000000100
1111000000000100
1100000100000100
1110000000011100
1110000000010000
1110000000010000
1110000000010000
1110001000010000
1110000000010000
1110000000010000
1100000000010000
1100000000010000