0000000010000000
0000000010000000
0000000110000000
0000000100000000
0000000100000100
0000000100000000
0000000100000000
1111111000000000
1100000000000111
1110000001000100
1111000000000100
1111100000000100