0000000010000000
0000000000000000
0001000000000100
0000000000000000
0000000000000000
0000000000000000
0000111111111111
0000100000000000
1111100000000000
0000000000000000
0000000000000000
0000000000000000