0000000000000000
0000000000000000
0000000000000111
0000001000000111
0000000000000111
0000000000000011
1111000000000000
0001000000000000
0001111100010000
0000000100000000
0000000100000000
0000000100000000