0000000100000000
0000000100000000
0000000100000100
0000000111000000
0000000001000000
0000000001000000
0000000001000000
0000000001000000
0000000001000000
0000000001000100
0000000001000000
0000000001000000