0000000001000000
0000000001000000
0000000001000000
0000001111000000
0000001000000000
0000001000000000
1111111000001000
0000000000000000
0000000000000000
0000000010000000
0000000000000000
0000000000000000