0000000000000000
0000000000000000
0000000000000000
1111111111000000
2222222222000000
2221222222000000
2221222212111111
2222222222000000
2222222220000000
2222222220000000
2222222220000000
2222222220000000